11,11,2,-1,-1,-1,-1,-1,-1,-1,-1,-1,-1,-1,-1,-1,-1,-1,-1,-1,-1,-1,-1,-1,-1,-1,-1,-1,-1
10,10,22,-1,-1,-1,-1,-1,-1,-1,-1,-1,-1,-1,41,41,41,41,41,-1,-1,-1,-1,-1,-1,12,-1,-1,-1
10,3,-1,-1,-1,-1,-1,-1,-1,-1,-1,-1,-1,-1,-1,12,-1,-1,-1,-1,-1,-1,14,0,11,11,11,2,-1
10,-1,-1,-1,-1,-1,-1,-1,-1,0,2,-1,-1,-1,-1,12,-1,-1,-1,-1,-1,14,0,12,12,12,12,11,-1
10,-1,-1,-1,-1,-1,-1,-1,-1,11,11,-1,-1,-1,-1,12,-1,-1,-1,-1,14,0,12,12,12,12,12,12,12
10,13,-1,-1,-1,-1,-1,-1,14,11,11,43,-1,-1,-1,12,-1,43,-1,14,0,11,12,12,12,11,12,12,12
11,11,11,11,11,11,11,11,11,11,11,11,11,11,11,11,11,11,11,11,11,11,11,12,12,12,12,12,-1
20,11,11,11,11,11,11,11,11,11,11,11,11,11,11,11,11,11,11,11,11,11,11,12,12,12,11,22,-1
